12:12 
0 0 0 0 18 0 18 0 0 0 0 0 
0 0 0 0 17 0 17 0 0 0 0 0 
0 0 0 0 18 0 18 0 0 0 0 0 
0 0 0 0 32 0 17 0 0 0 0 0 
17 18 17 32 32 0 18 17 18 17 18 17 
0 0 0 0 0 0 0 0 0 0 0 0 
17 18 17 18 17 0 32 32 17 18 17 18 
0 0 0 0 18 0 32 0 0 0 0 0 
0 0 0 0 17 0 17 0 0 0 0 0 
0 0 0 0 18 0 18 0 0 0 0 0 
0 0 0 0 17 0 17 0 0 0 0 0 
0 0 0 0 18 0 18 0 0 0 0 59 
