12:12
0 0 0 0 0 0 0 0 0 0 0 64 
17 17 17 0 17 0 17 17 17 17 0 0 
0 0 0 0 17 32 17 0 0 17 0 0 
32 0 0 0 17 32 17 0 0 17 0 0 
0 0 0 0 17 32 17 0 0 17 0 0 
0 0 0 0 17 17 17 0 0 17 0 0 
0 0 0 0 0 0 0 0 0 17 0 0 
0 18 17 18 0 0 0 0 0 17 0 0 
0 18 18 18 0 0 0 0 0 17 0 0 
0 0 0 0 0 0 0 0 0 17 0 0 
32 17 17 17 17 17 17 17 17 17 32 32 
32 0 0 59 0 0 0 0 0 0 0 0 
