12:12
0 17 17 17 17 17 17 17 17 17 17 17
0 0 0 0 32 32 0 0 0 0 0 17
0 0 0 0 32 32 0 0 0 0 0 17
0 0 0 0 32 32 0 0 0 0 0 17
0 0 0 0 32 0 0 0 0 0 0 17
17 0 0 0 18 0 0 0 0 0 0 17
17 0 0 0 18 0 0 0 0 0 0 17
17 0 0 0 18 0 0 0 0 0 0 17
17 0 0 0 18 0 0 0 0 0 0 17
17 0 0 0 18 0 0 0 0 0 0 17
17 0 0 0 18 0 0 0 0 0 0 0
17 17 17 17 17 17 17 17 17 32 32  59 
